WWWWWWWWWWWWWWWWWWWWWWWWWWWW
W...........OWW............W
W.WWWW.WWWWW.WW.WWWWW.WWWW.W
WXWWWW.WWWWW.WW.WWWWW.WWWWXW
W..........................W
W.WWWW.WW.WWWWWWWW.WW.WWWW.W
W......WW....WW....WW......W
WWWWWW.WWWWW.WW.WWWWW.WWWWWW
     W.WW..........WW.W
     W.WW.WWWWWW-W.WW.W
WWWWWW.WW.W VVVV W.WW.WWWWWW
....X.....W VVVV W.....X....      
WWWWWW.WW.W VVVV W.WW.WWWWWW
     W.WW.W-WWWWWW.WW.W
     W.WW....FP....WW.W     
WWWWWW.WW.WWWWWWWW.WW.WWWWWW
W............WW..O.........W
W.WWWW.WWWWW.WW.WWWWW.WWWW.W
WX..WW................WW..XW
WWW.WW.WW.WWWWWWWW.WW.WW.WWW
W......WW....WW....WW......W
W.WWWWWWWWWW.WW.WWWWWWWWWW.W
W...................O......W
WWWWWWWWWWWWWWWWWWWWWWWWWWWW